11111111111111111111111
10010000100010100000011
11011010101010101111011
11001010101010101001011
11101010001010001101011
11001010111010100001011
11011110100200111101111
11010000101010011101011
11010111101111010101011
11010000100000010101011
11010111111111110101011
11000000000000000100001
11111111111111111111111
